constituency	name	party
Aberavon	Jack Edwards	Coalition Liberal
Aberdare	Charles Stanton	Coalition NDP
Aberdeen North	Frank Rose	Independent Labour
Aberdeen South	Frederick Thomson	Coalition Conservative
Aberdeenshire Central	Sir Alexander Theodore Gordon	Coalition Conservative
Aberdeenshire East	Sir Henry Cowan	Coalition Liberal
Aberdeenshire West and Kincardine	Hon. Arthur Murray	Coalition Liberal
Abertillery	William Brace	Labour
Abingdon	John Tyson Wigan	Coalition Conservative
Accrington	Ernest Gray	Coalition Conservative
Acton	Sir Harry Brittain	Coalition Conservative
Aldershot	Viscount Wolmer	Coalition Conservative
Altrincham	George Hamilton	Coalition Conservative
Anglesey	Sir Owen Thomas	Independent Labour
Antrim East	Robert McCalmont	Irish Unionist
Antrim Mid	Hon. Hugh O'Neill	Irish Unionist
Antrim North	Peter Kerr-Smiley	Irish Unionist
Antrim South	Charles Craig	Irish Unionist
Argyllshire	William Sutherland	Coalition Liberal
Armagh Mid	James Lonsdale	Irish Unionist
Armagh North	William Allen	Irish Unionist
Armagh South	Patrick Donnelly	Irish Nationalist
Ashford	Samuel Strang Steel	Coalition Conservative
Ashton-under-Lyne	Sir Albert Stanley	Coalition Conservative
Aylesbury	Lionel de Rothschild	Coalition Conservative
Ayr Burghs	Sir George Younger, Bt	Coalition Conservative
Ayrshire North and Bute	Sir Aylmer Hunter-Weston	Coalition Conservative
Ayrshire South	James Brown	Labour
Balham and Tooting	John Denison-Pender	Coalition Conservative
Banbury	Sir Rhys Rhys-Williams, Bt	Coalition Liberal
Banff	Charles Barrie	Coalition Liberal
Barkston Ash	George Lane-Fox	Coalition Conservative
Barnard Castle	John Swan	Labour
Barnsley	Sir Joseph Walton	Coalition Liberal
Barnstaple	Tudor Rees	Coalition Liberal
Barrow-in-Furness	Robert Burton-Chadwick	Conservative
Basingstoke	Auckland Geddes	Coalition Conservative
Bassetlaw	Sir William Hume-Williams	Coalition Conservative
Bath	Charles Foxcroft	Coalition Conservative
Batley and Morley	Gerald France	Coalition Liberal
Battersea North	Richard Morris	Coalition Liberal
Battersea South	Viscount Curzon	Coalition Conservative
Bedford	Frederick Kellaway	Coalition Liberal
Bedfordshire Mid	Max Townley	Coalition Conservative
Bedwellty	Charles Edwards	Labour
Belfast Cromac	William Arthur Lindsay	Irish Unionist
Belfast Duncairn	Sir Edward Carson	Irish Unionist
Belfast Falls	Joseph Devlin	Irish Nationalist
Belfast Ormeau	Thomas Moles	Irish Unionist
Belfast Pottinger	Herbert Dixon	Irish Unionist
Belfast Shankill	Samuel McGuffin	Labour Unionist
Belfast St Anne's	Thomas Henry Burn	Labour Unionist
Belfast Victoria	Thompson Donald	Labour Unionist
Belfast Woodvale	Robert Lynn	Irish Unionist
Belper	John Hancock	Liberal
Bermondsey West	Harold Glanville	Liberal
Berwick-on-Tweed	Sir Francis Blake, Bt	Liberal
Berwick and Haddington	John Hope	Coalition Liberal
Bethnal Green North-East	Sir Edwin Cornwall, Bt	Coalition Liberal
Bethnal Green South-West	Sir Mathew Wilson, Bt	Coalition Conservative
Bewdley	Stanley Baldwin	Coalition Conservative
Birkenhead East	Alfred Bigland	Coalition Conservative
Birkenhead West	Henry Grayson	Coalition Conservative
Birmingham Aston	Evelyn Cecil	Coalition Conservative
Birmingham Deritend	John William Dennis	Coalition Conservative
Birmingham Duddeston	Eldred Hallas	Coalition NDP
Birmingham Edgbaston	Sir Francis Lowe, Bt	Coalition Conservative
Birmingham Erdington	Sir Arthur Steel-Maitland, Bt	Coalition Conservative
Birmingham Handsworth	Ernest Meysey-Thompson	Coalition Conservative
Birmingham King's Norton	Sir Herbert Austin	Coalition Conservative
Birmingham Ladywood	Neville Chamberlain	Coalition Conservative
Birmingham Moseley	Sir Hallewell Rogers	Coalition Conservative
Birmingham Sparkbrook	Leo Amery	Coalition Conservative
Birmingham West	Sir Austen Chamberlain	Coalition Conservative
Birmingham Yardley	Alfred Jephcott	Coalition Conservative
Bishop Auckland	Ben Spoor	Labour
Blackburn 	Sir Henry Norman, Bt	Coalition Liberal
Blackburn 	Percy Dean	Coalition Conservative
Blackpool	Albert Lindsay Parkinson	Coalition Conservative
Blaydon	Walter Waring	Coalition Liberal
Bodmin	Sir Charles Hanson, Bt	Coalition Conservative
Bolton 	Robert Tootill	Labour
Bolton 	William Edge	Coalition Liberal
Bootle	Sir Thomas Royden, Bt	Coalition Conservative
Bosworth	Hon. Henry McLaren	Coalition Liberal
Bothwell	David Macdonald	Coalition Conservative
Bournemouth	Sir Henry Page Croft	National Party
Bow and Bromley	Reginald Blair	Coalition Conservative
Bradford Central	Henry Butler Ratcliffe	Coalition Conservative
Bradford East	Charles Edgar Loseby	Coalition NDP
Bradford North	Archibald Boyd-Carpenter	Coalition Conservative
Bradford South	Vernon Willey	Coalition Conservative
Brecon and Radnor	Sidney Robinson	Coalition Liberal
Brentford and Chiswick	Walter Morden	Coalition Conservative
Bridgwater	Robert Sanders	Coalition Conservative
Brigg	C. W. W. McLean	Coalition Conservative
Brighton 	George Tryon	Coalition Conservative
Brighton 	Charles Thomas-Stanford	Coalition Conservative
Bristol Central	Thomas Inskip	Coalition Conservative
Bristol East	George Britton	Coalition Liberal
Bristol North	Stanley Gange	Coalition Liberal
Bristol South	Sir Howell Davies	Coalition Liberal
Bristol West	George Gibbs	Coalition Conservative
Brixton	Davison Dalziel	Coalition Conservative
Bromley	Henry Forster	Coalition Conservative
Broxtowe	George Spencer	Labour
Buckingham	George Bowyer	Coalition Conservative
Buckrose	Algernon Moreing	Coalition Liberal
Burnley	Dan Irving	Labour
Burslem	Samuel Finney	Labour
Burton	John Gretton	Coalition Conservative
Bury	Charles Ainsworth	Conservative
Bury St Edmunds	Hon. Walter Guinness	Coalition Conservative
Caerphilly	Alfred Onions	Labour
Caithness and Sutherland	Sir Leicester Harmsworth	Coalition Liberal
Camberwell North	Henry Newton Knights	Coalition Conservative
Camberwell North-West	Thomas Macnamara	Coalition Liberal
Camborne	Francis Dyke Acland	Liberal
Cambridge	Sir Eric Geddes	Coalition Conservative
Cambridgeshire	Hon. Edwin Montagu	Coalition Liberal
Cambridge University	Sir Joseph Larmor	Coalition Conservative
Cambridge University	John Rawlinson	Coalition Conservative
Cannock	James Parker	Coalition Labour
Canterbury	Ronald McNeill	Coalition Conservative
Cardiff Central	James Childs Gould	Conservative
Cardiff East	Sir William Seager	Liberal
Cardiff South	Herbert Cory	Conservative
Cardiganshire	Matthew Vaughan-Davies	Coalition Liberal
Carlisle	Theodore Carr	Coalition Liberal
Carlow	James Lennon	Sinn Féin
Carmarthen	John Hinds	Coalition Liberal
Carnarvon Boroughs	David Lloyd George	Coalition Liberal
Carnarvonshire	Charles Breese	Coalition Liberal
Cavan East	Arthur Griffith	Sinn Féin
Cavan West	Paul Galligan	Sinn Féin
Chatham	John Moore-Brabazon	Conservative
Chelmsford	E. G. Pretyman	Coalition Conservative
Chelsea	Sir Samuel Hoare, Bt	Coalition Conservative
Cheltenham	Sir James Agg-Gardner	Coalition Conservative
Chertsey	Donald Macmaster	Coalition Conservative
Chester	Sir Owen Philipps	Coalition Conservative
Chesterfield	Barnet Kenyon	Liberal
Chester-le-Street	John Wilkinson Taylor	Labour
Chichester	Edmund Talbot	Coalition Conservative
Chippenham	George Terrell	Coalition Conservative
Chislehurst	Alfred Smithers	Coalition Conservative
Chorley	Douglas Hacking	Coalition Conservative
Cirencester and Tewkesbury	Thomas Davies	Coalition Conservative
City of London 	Sir Frederick Banbury, Bt	Coalition Conservative
City of London 	Arthur Balfour	Coalition Conservative
Clapham	Sir Arthur du Cros, Bt	Coalition Conservative
Clare East	Éamon de Valera	Sinn Féin
Clare West	Brian O'Higgins	Sinn Féin
Clay Cross	Thomas Broad	Coalition Liberal
Cleveland	Sir Park Goff	Coalition Conservative
Clitheroe	Alfred Davies	Labour
Coatbridge	A. L. H. Buchanan	Coalition Conservative
Colchester	Sir Laming Worthington-Evans, Bt	Coalition Conservative
Colne Valley	Frederick Mallalieu	Coalition Liberal
Combined English Universities 	Sir Martin Conway	Coalition Conservative
Combined English Universities 	H. A. L. Fisher	Coalition Liberal
Combined Scottish Universities 	Sir William Cheyne, Bt	Coalition Conservative
Combined Scottish Universities 	Dugald Cowan	Coalition Liberal
Combined Scottish Universities 	Sir Henry Craik	Coalition Conservative
Consett	Aneurin Williams	Liberal
Cork City 	Liam de Róiste	Sinn Féin
Cork City 	James J. Walsh	Sinn Féin
County Cork East	David Kent	Sinn Féin
County Cork Mid	Terence MacSwiney	Sinn Féin
County Cork North	Patrick O'Keeffe	Sinn Féin
County Cork North East	Thomas Hunter	Sinn Féin
County Cork South	Michael Collins	Sinn Féin
County Cork South East	Diarmuid Lynch	Sinn Féin
County Cork West	Seán Hayes	Sinn Féin
Cornwall North	Sir George Marks	Coalition Liberal
Coventry	Edward Manville	Coalition Conservative
Crewe	Joseph Davies	Coalition Liberal
Croydon North	George Borwick	Coalition Conservative
Croydon South	Ian Malcolm	Coalition Conservative
Cumberland North	Christopher Lowther	Coalition Conservative
Darlington	Herbert Pease	Coalition Conservative
Dartford	James Rowlands	Coalition Liberal
Darwen	Sir John Rutherford, Bt	Coalition Conservative
Daventry	Hon. Edward FitzRoy	Coalition Conservative
Denbigh	Sir David Davies	Coalition Liberal
Deptford	C. W. Bowerman	Labour
Derby 	J. H. Thomas	Labour
Derby 	Albert Green	Conservative
Derbyshire North East	Stanley Holmes	Liberal
Derbyshire South	Holman Gregory	Coalition Liberal
Derbyshire West	Charles Frederick White	Liberal
Devizes	Cory Bell	Coalition Conservative
Dewsbury	Emil Pickering	Coalition Conservative
Doncaster	Reginald Nicholson	Coalition Liberal
Don Valley	James Walton	Coalition NDP
Donegal East	Edward Kelly	Irish Nationalist
Donegal North	Joseph O'Doherty	Sinn Féin
Donegal South	Peter J. Ward	Sinn Féin
Donegal West	Joseph Sweeney	Sinn Féin
Down East	David Reid	Irish Unionist
Down Mid	Sir James Craig, Bt	Irish Unionist
Down North	Thomas Watters Brown	Irish Unionist
Down South	Jeremiah McVeagh	Irish Nationalist
Down West	Daniel Martin Wilson	Irish Unionist
Dorset East	Hon. Freddie Guest	Coalition Liberal
Dorset North	Philip Colfox	Coalition Conservative
Dorset South	Angus Hambro	Coalition Conservative
Dorset West	Sir Robert Williams, Bt	Coalition Conservative
Dover	Viscount Duncannon	Coalition Conservative
Dublin Clontarf	Richard Mulcahy	Sinn Féin
Dublin College Green	Seán T. O'Kelly	Sinn Féin
Dublin County North	Frank Lawless	Sinn Féin
Dublin County South	George Gavan Duffy	Sinn Féin
Dublin Harbour	Philip Shanahan	Sinn Féin
Dublin Pembroke	Desmond FitzGerald	Sinn Féin
Dublin Rathmines	Sir Maurice Dockrell	Irish Unionist
Dublin St James's	Joseph McGrath	Sinn Féin
Dublin St Michan's	Michael Staines	Sinn Féin
Dublin St Patrick's	Constance Markievicz	Sinn Féin
Dublin St Stephen's Green	Thomas Kelly	Sinn Féin
Dublin University	Arthur Samuels	Irish Unionist
Dublin University	Sir Robert Woods	Ind. Unionist
Dudley	Sir Arthur Griffith-Boscawen	Coalition Conservative
Dulwich	Sir Frederick Hall	Coalition Conservative
Dumbarton Burghs	John Taylor	Coalition Liberal
Dumfriesshire	William Murray	Coalition Conservative
Dunbartonshire	William Raeburn	Coalition Conservative
Dundee 	Winston Churchill	Coalition Liberal
Dundee 	Alexander Wilkie	Labour
Dunfermline Burghs	John Wallace	Coalition Liberal
Durham	John Hills	Coalition Conservative
Ealing	Sir Herbert Nield	Coalition Conservative
Eastbourne	Rupert Gwynne	Coalition Conservative
East Grinstead	Henry Cautley	Coalition Conservative
East Ham North	Sir John Bethell, Bt	Coalition Liberal
East Ham South	Clement Edwards	Coalition NDP
Ebbw Vale	Thomas Richards	Labour
Eccles	Marshall Stevens	Coalition Conservative
Eddisbury	Harry Barnston	Coalition Conservative
Edinburgh Central	William Graham	Labour
Edinburgh East	James Hogge	Liberal
Edinburgh North	James Avon Clyde	Coalition Conservative
Edinburgh South	Charles Murray	Coalition Conservative
Edinburgh West	John Gordon Jameson	Coalition Conservative
Edmonton	Sir Alfred Warren	Coalition Conservative
Elland	George Taylor Ramsden	Coalition Conservative
Enfield	Henry Bowles	Coalition Conservative
Epping	Richard Colvin	Coalition Conservative
Epsom	George Blades	Coalition Conservative
Essex South East	Frank Hilder	Coalition Conservative
Evesham	Bolton Eyres-Monsell	Coalition Conservative
Exeter	Sir Robert Newman, Bt	Coalition Conservative
Eye	Alexander Lyle-Samuel	Coalition Liberal
Fareham	John Davidson	Coalition Conservative
Farnham	Arthur Samuel	Coalition Conservative
Farnworth	Edward Bagley	Conservative
Faversham	Granville Wheler	Coalition Conservative
Fermanagh North	Edward Archdale	Irish Unionist
Fermanagh South	Seán O'Mahony	Sinn Féin
Fife East	Sir Alexander Sprot, Bt	Conservative
Fife West	William Adamson	Labour
Finchley	John Pretyman Newman	Coalition Conservative
Finsbury	Martin Archer-Shee	Coalition Conservative
Flintshire	Tom Parry	Coalition Liberal
Forest of Dean	James Wignall	Labour
Forfarshire	William T. Shaw	Conservative
Frome	Percy Hurd	Coalition Conservative
Fulham East	Sir Henry Norris	Coalition Conservative
Fulham West	Sir Cyril Cobb	Coalition Conservative
Fylde	Wilfrid Ashley	Coalition Conservative
Gainsborough	John Molson	Coalition Conservative
Galloway	Gilbert McMicking	Coalition Liberal
Galway Connemara	Pádraic Ó Máille	Sinn Féin
Galway East	Liam Mellows	Sinn Féin
Galway North	Bryan Cusack	Sinn Féin
Galway South	Frank Fahy	Sinn Féin
Gateshead	Herbert Surtees	Coalition Conservative
Gillingham	Gerald Hohler	Coalition Conservative
Glasgow Bridgeton	MacCallum Scott	Coalition Liberal
Glasgow Camlachie	Halford Mackinder	Coalition Conservative
Glasgow Cathcart	John Pratt	Coalition Liberal
Glasgow Central	Bonar Law	Coalition Conservative
Glasgow Gorbals	George Barnes	Coalition Labour
Glasgow Govan	Neil Maclean	Labour
Glasgow Hillhead	Sir Robert Horne	Coalition Conservative
Glasgow Kelvingrove	John MacLeod	Coalition Conservative
Glasgow Maryhill	Sir William Mitchell-Thomson, Bt	Coalition Conservative
Glasgow Partick	Sir Robert Balfour, Bt	Coalition Liberal
Glasgow Pollok	John Gilmour	Coalition Conservative
Glasgow St. Rollox	Hon. Gideon Oliphant-Murray	Coalition Conservative
Glasgow Shettleston	T. B. S. Adair	Coalition Conservative
Glasgow Springburn	F. A. Macquisten	Coalition Conservative
Glasgow Tradeston	Vivian Henderson	Coalition Conservative
Gloucester	Sir James Bruton	Coalition Conservative
Gower	John Williams	Labour
Grantham	Edmund Royds	Coalition Conservative
Gravesend	Alexander Richardson	Coalition Conservative
Great Yarmouth	Sir Arthur Fell	Coalition Conservative
Greenock	Godfrey Collins	Liberal
Greenwich	Ion Hamilton Benn	Coalition Conservative
Grimsby	Thomas Tickler	Coalition Conservative
Guildford	Edgar Horne	Coalition Conservative
Hackney Central	William Woolcock	Coalition Liberal
Hackney North	Raymond Greene	Coalition Conservative
Hackney South	Horatio Bottomley	Independent
Halifax	John Henry Whitley	Coalition Liberal
Hamilton	Duncan Graham	Labour
Hammersmith North	Henry Foreman	Coalition Conservative
Hammersmith South	William Bull	Coalition Conservative
Hampstead	George Balfour	Coalition Conservative
Hanley	James Seddon	Coalition NDP
Harborough	Sir Keith Fraser, Bt	Coalition Conservative
Harrow	Oswald Mosley	Coalition Conservative
The Hartlepools	W. G. Howard Gritten	Conservative
Harwich	Harry Newton	Coalition Conservative
Hastings	Laurance Lyon	Coalition Conservative
Hemel Hempstead	Gustavus Talbot	Coalition Conservative
Hemsworth	John Guest	Labour
Hendon	Philip Lloyd-Greame	Coalition Conservative
Henley	Reginald Terrell	Coalition Conservative
Hereford	Charles Pulley	Coalition Conservative
Hertford	Noel Pemberton Billing	Silver Badge
Hexham	Clifton Brown	Coalition Conservative
Heywood and Radcliffe	Albert Illingworth	Coalition Liberal
High Peak	Samuel Hill-Wood	Coalition Conservative
Hitchin	Robert Cecil	Coalition Conservative
Holborn	Sir James Remnant, Bt	Coalition Conservative
Holderness	Stanley Wilson	Coalition Conservative
Holland-with-Boston	William Royce	Labour
Honiton	Clive Morrison-Bell	Coalition Conservative
Horncastle	William Weigall	Coalition Conservative
Hornsey	Kennedy Jones	Coalition Conservative
Horsham and Worthing	The Earl Winterton	Coalition Conservative
Houghton-le-Spring	Robert Richardson	Labour
Howdenshire	Stanley Jackson	Coalition Conservative
Huddersfield	Charles Sykes	Coalition Liberal
Huntingdonshire	Oliver Locker-Lampson	Coalition Conservative
Hythe	Sir Philip Sassoon, Bt	Coalition Conservative
Ilford	Sir William Griggs	Coalition Conservative
Ilkeston	J. E. B. Seely	Coalition Liberal
Ince	Stephen Walsh	Labour
Inverness	Thomas Morison	Coalition Liberal
Ipswich	John Ganzoni	Coalition Conservative
Isle of Ely	Colin Coote	Coalition Liberal
Isle of Thanet	Norman Craig	Coalition Conservative
Isle of Wight	Douglas Hall	Coalition Conservative
Islington East	Alfred Raper	Coalition Conservative
Islington North	Sir Newton Moore	Coalition Conservative
Islington South	Sir Charles Higham	Coalition Conservative
Islington West	Sir George Elliott	Coalition Conservative
Jarrow	Godfrey Palmer	Coalition Liberal
Keighley	Robert Clough	Coalition Conservative
Kennington	Henry Purchase	Coalition Liberal
Kensington North	Alan Burgoyne	Coalition Conservative
Kensington South	Sir William Davison	Coalition Conservative
Kerry East	Piaras Béaslaí	Sinn Féin
Kerry North	James Crowley	Sinn Féin
Kerry South	Fionán Lynch	Sinn Féin
Kerry West	Austin Stack	Sinn Féin
Kettering	Alfred Waterson	Co-operative -> Labour
Kidderminster	Eric Knight	Coalition Conservative
Kildare North	Domhnall Ua Buachalla	Sinn Féin
Kildare South	Art O'Connor	Sinn Féin
Kilkenny North	W. T. Cosgrave	Sinn Féin
Kilkenny South	James O'Mara	Sinn Féin
Kilmarnock	Hon. Alexander Shaw	Coalition Liberal
King's County	Patrick McCartan	Sinn Féin
King's Lynn	Neville Jodrell	Coalition Conservative
Kingston upon Hull Central	Sir Mark Sykes, Bt	Coalition Conservative
Kingston upon Hull East	Charles Murchison	Coalition Conservative
Kingston upon Hull North West	Lambert Ward	Conservative
Kingston upon Hull South West	Cyril Entwistle	Liberal
Kingston-upon-Thames	John Gordon Drummond Campbell	Coalition Conservative
Kingswinford	Charles Sitch	Labour
Kinross & West Perthshire	James Gardiner	Liberal
Kirkcaldy Burghs	Sir James Dalziel	Coalition Liberal
Knutsford	Sir Alan Sykes, Bt	Coalition Conservative
Lambeth North	Frank Briant	Liberal
Lanark	Walter Elliot	Coalition Conservative
Lanarkshire North	Robert McLaren	Coalition Conservative
Lancaster	Sir Archibald Hunter	Coalition Conservative
Leeds Central	Robert Armitage	Coalition Liberal
Leeds North	Alexander Farquharson	Coalition Liberal
Leeds North East	Sir John Birchall	Coalition Conservative
Leeds South	William Middlebrook	Coalition Liberal
Leeds South East	James O'Grady	Labour
Leeds West	John Murray	Coalition Liberal
Leek	William Bromfield	Labour
Leicester East	Sir Gordon Hewart	Coalition Liberal
Leicester South	Thomas Blane	Coalition Conservative
Leicester West	Joseph Frederick Green	Coalition NDP
Leigh	Peter Raffan	Liberal
Leith	William Wedgwood Benn	Liberal
Leitrim	James Dolan	Sinn Féin
Leominster	Charles Ward-Jackson	Coalition Conservative
Lewes	William Campion	Coalition Conservative
Lewisham East	Sir Assheton Pownall	Coalition Conservative
Lewisham West	Sir Edward Coates	Coalition Conservative
Leyton East	Cecil Malone	Coalition Liberal
Leyton West	Harry Wrightson	Coalition Conservative
Lichfield	Sir Courtenay Warner, Bt	Coalition Liberal
Limerick City	Michael Collivet	Sinn Féin
Limerick East	Richard Hayes	Sinn Féin
Limerick West	Con Collins	Sinn Féin
Lincoln	Alfred Davies	Coalition Conservative
Linlithgow	James Kidd	Coalition Conservative
Liverpool East Toxteth	James Stuart Rankin	Coalition Conservative
Liverpool Edge Hill	William Rutherford	Coalition Conservative
Liverpool Everton	John Harmood-Banner	Coalition Conservative
Liverpool Exchange	Leslie Scott	Coalition Conservative
Liverpool Fairfield	Jack Cohen	Conservative
Liverpool Kirkdale	De Fonblanque Pennefather	Coalition Conservative
Liverpool Scotland	T. P. O'Connor	Irish Nationalist
Liverpool Walton	Harry Chilcott	Coalition Conservative
Liverpool Wavertree	Nathan Raw	Coalition Conservative
Liverpool West Derby	Sir F. E. Smith	Coalition Conservative
Liverpool West Toxteth	Robert Houston	Coalition Conservative
Llandaff and Barry	William Cope	Coalition Conservative
Llanelli	Towyn Jones	Coalition Liberal
London University	Sir Philip Magnus, Bt	Coalition Conservative
Londonderry City	Eoin MacNeill	Sinn Féin
Londonderry North	Hugh Anderson	Irish Unionist
Londonderry South	Denis Henry	Irish Unionist
Longford	Joseph McGuinness	Sinn Féin
Lonsdale	Claude Lowther	Coalition Conservative
Loughborough	Hon. Oscar Guest	Coalition Liberal
Louth	John J. O'Kelly	Sinn Féin
Louth 	Langton Brackenbury	Coalition Conservative
Lowestoft	Sir Edward Beauchamp, Bt	Coalition Liberal
Ludlow	Sir Beville Stanier, Bt	Coalition Conservative
Luton	Cecil Harmsworth	Coalition Liberal
Macclesfield	John Remer	Coalition Conservative
Maidstone	Carlyon Bellairs	Coalition Conservative
Maldon	Sir James Fortescue Flannery, Bt	Coalition Conservative
Manchester Ardwick	Augustine Hailwood	Coalition Conservative
Manchester Blackley	Harold Briggs	Conservative
Manchester Clayton	Edward Hopkinson	Conservative
Manchester Exchange	Sir John Randles	Coalition Conservative
Manchester Gorton	John Hodge	Labour
Manchester Hulme	Joseph Nall	Conservative
Manchester Moss Side	Gerald Hurst	Conservative
Manchester Platting	J. R. Clynes	Labour
Manchester Rusholme	Robert Burdon Stoker	Coalition Conservative
Manchester Withington	Alfred Deakin Carter	Conservative
Mansfield	William Carter	Labour
Mayo East	Éamon de Valera	Sinn Féin
Mayo North	John Crowley	Sinn Féin
Mayo South	William Sears	Sinn Féin
Mayo West	Joseph MacBride	Sinn Féin
Meath North	Liam Mellows	Sinn Féin
Meath South	Eamonn Duggan	Sinn Féin
Melton	Charles Yate	Coalition Conservative
Merionethshire	Sir Henry Haydn Jones	Liberal
Merthyr	Sir Edgar Jones	Coalition Liberal
Middlesbrough East	Penry Williams	Liberal
Middlesbrough West	Trevelyan Thomson	Liberal
Middleton and Prestwich	Sir Ryland Adkins	Coalition Liberal
Midlothian North	Sir John Hope, Bt	Coalition Conservative
Midlothian South and Peebles	Sir Donald Maclean	Liberal
Mitcham	Thomas Worsfold	Coalition Conservative
Monaghan North	Ernest Blythe	Sinn Féin
Monaghan South	Seán MacEntee	Sinn Féin
Monmouth	Leolin Forestier-Walker	Conservative
Montgomeryshire	David Davies	Liberal
Montrose Burghs	John Sturrock	Coalition Liberal
Moray & Nairn	Sir Archibald Williamson, Bt	Coalition Liberal
Morpeth	John Cairns	Labour
Mossley	Austin Hopkinson	Coalition Liberal
Motherwell	Robert Nelson	Coalition Conservative
National University of Ireland	Eoin MacNeill	Sinn Féin
Neath	Hugh Edwards	Coalition Liberal
Nelson and Colne	Albert Smith	Labour
Newark	John Starkey	Coalition Conservative
Newbury	William Mount	Coalition Conservative
Newcastle-under-Lyme	Josiah Wedgwood	Independent Liberal -> Labour
Newcastle-upon-Tyne Central	George Renwick	Coalition Conservative
Newcastle-upon-Tyne East	Harry Barnes	Coalition Liberal
Newcastle-upon-Tyne North	Nicholas Grattan-Doyle	Coalition Conservative
Newcastle-upon-Tyne West	Edward Shortt	Coalition Liberal
New Forest and Christchurch	Walter Perkins	Coalition Conservative
Newport	Lewis Haslam	Coalition Liberal
Newton	Robert Young	Labour
Norfolk East	Michael Falcon	Coalition Conservative
Norfolk North	Douglas King	Coalition Independent
Norfolk South	Hon. William Cozens-Hardy	Liberal
Norfolk South West	Sir Richard Winfrey	Coalition Liberal
Normanton	Frederick Hall	Labour
Northampton	Charles McCurdy	Coalition Liberal
Northwich	Harry Dewhurst	Coalition Conservative
Norwich 	Hilton Young	Liberal
Norwich 	George Roberts	Coalition Labour
Norwood	Sir Harry Samuel	Coalition Conservative
Nottingham Central	Albert Atkey	Coalition Conservative
Nottingham East	Sir John Rees	Coalition Conservative
Nottingham South	Lord Henry Cavendish-Bentinck	Coalition Conservative
Nottingham West	Arthur Hayday	Labour
Nuneaton	Henry Maddocks	Coalition Conservative
Ogmore	Vernon Hartshorn	Labour
Oldham 	Sir William Barton	Coalition Liberal
Oldham 	Edmund Denniss	Coalition Conservative
Orkney and Shetland	Cathcart Wason	Coalition Liberal
Ormskirk	James Bell	Labour
Oswestry	William Bridgeman	Coalition Conservative
Oxford	John Marriott	Coalition Conservative
Oxford University	Lord Hugh Cecil	Coalition Conservative
Oxford University	Rowland Prothero	Coalition Conservative
Paddington North	William Perring	Coalition Conservative
Paddington South	Sir Henry Percy Harris	Coalition Conservative
Paisley	Sir John McCallum	Liberal
Peckham	Sir Albion Richardson	Coalition Liberal
Pembrokeshire	Sir Evan Jones, Bt	Coalition Liberal
Penistone	Sydney Arnold	Liberal
Penrith and Cockermouth	James Lowther	Coalition Conservative
Penryn and Falmouth	Sir Edward Nicholl	Coalition Conservative
Perth	William Young	Coalition Liberal
Peterborough	Henry Brassey	Coalition Conservative
Petersfield	William Graham Nicholson	Coalition Conservative
Plymouth Devonport	Clement Kinloch-Cooke	Coalition Conservative
Plymouth Drake	Sir Arthur Benn	Coalition Conservative
Plymouth Sutton	Hon. Waldorf Astor	Coalition Conservative
Pontefract	Sir Joseph Compton-Rickett	Coalition Liberal
Pontypool	Thomas Griffiths	Labour
Pontypridd	Thomas Arthur Lewis	Coalition Liberal
Poplar South	Sir Alfred William Yeo	Coalition Liberal
Portsmouth Central	Sir Thomas Bramsdon	Liberal
Portsmouth North	Sir Bertram Falle, Bt	Coalition Conservative
Portsmouth South	Herbert Cayzer	Coalition Conservative
Preston 	Hon. George Stanley	Coalition Conservative
Preston 	Thomas Shaw	Labour
Pudsey and Otley	Arthur Barrand	Coalition Liberal
Putney	Samuel Samuel	Coalition Conservative
Queen's County	Kevin O'Higgins	Sinn Féin
Queen's University of Belfast	Sir William Whitla	Irish Unionist
Reading	Leslie Wilson	Coalition Conservative
Reigate	George Cockerill	Coalition Conservative
Renfrewshire East	Joseph Johnstone	Coalition Liberal
Renfrewshire West	James Greig	Coalition Liberal
Rhondda East	David Watts-Morgan	Labour
Rhondda West	William Abraham	Labour
Richmond 	Murrough Wilson	Coalition Conservative
Richmond upon Thames	Clifford Edgar	Coalition Conservative
Ripon	Hon. Edward Wood	Coalition Conservative
Rochdale	Alfred Law	Coalition Conservative
Romford	Albert Edward Martin	Coalition Liberal
Roscommon North	George Noble Plunkett	Sinn Féin
Roscommon South	Harry Boland	Sinn Féin
Ross and Cromarty	Ian Macpherson	Coalition Liberal
Rossendale	Robert Waddington	Coalition Conservative
Rotherham	Frederic Kelley	Conservative
Rotherhithe	John Lort-Williams	Coalition Conservative
Rother Valley	Thomas Walter Grundy	Labour
Rothwell	William Lunn	Labour
Roxburgh and Selkirk	Robert Munro	Coalition Liberal
Royton	Wilfrid Sugden	Coalition Conservative
Rugby	John Baird	Coalition Conservative
Rushcliffe	Henry Betterton	Coalition Conservative
Rutland and Stamford	Hon. Claud Heathcote-Drummond-Willoughby	Coalition Conservative
Rutherglen	Adam Keir Rodger	Coalition Liberal
Rye	George Courthope	Coalition Conservative
Saffron Walden	Cecil Beck	Coalition Liberal
St Albans	Sir Hildred Carlile, Bt	Coalition Conservative
St Helens	James Sexton	Labour
St Ives	Sir Clifford Cory, Bt	Coalition Liberal
St Marylebone	Sir Samuel Scott, Bt	Coalition Conservative
St Pancras North	John Lorden	Coalition Conservative
St Pancras South East	John Hopkins	Conservative
St Pancras South West	Richard Barnett	Coalition Conservative
Salford North	Ben Tillett	Labour
Salford South	Sir Anderson Montague-Barlow	Coalition Conservative
Salford West	Fred Astbury	Conservative
Salisbury	Hugh Morrison	Coalition Conservative
Scarborough and Whitby	Gervase Beckett	Coalition Conservative
Seaham	Evan Hayward	Liberal
Sedgefield	Rowland Burdon	Coalition Conservative
Sevenoaks	Thomas Jewell Bennett	Coalition Conservative
Sheffield Attercliffe	Thomas Worrall Casey	Coalition Liberal
Sheffield Brightside	Sir Tudor Walters	Coalition Liberal
Sheffield Central	James Hope	Coalition Conservative
Sheffield Ecclesall	Samuel Roberts	Coalition Conservative
Sheffield Hallam	Douglas Vickers	Coalition Conservative
Sheffield Hillsborough	Arthur Neal	Coalition Liberal
Sheffield Park	Henry Stephenson	Coalition Liberal
Shipley	Norman Rae	Coalition Liberal
Shoreditch	Christopher Addison	Coalition Liberal
Shrewsbury	George Butler Lloyd	Coalition Conservative
Skipton	Richard Roundell	Coalition Conservative
Sligo North	J. J. Clancy	Sinn Féin
Sligo South	Alexander McCabe	Sinn Féin
Smethwick	John Davison	Labour
Southampton 	Sir Ivor Philipps	Coalition Liberal
Southampton 	William Dudley Ward	Coalition Liberal
Southend-on-Sea	Hon. Rupert Guinness	Coalition Conservative
Southport	Godfrey Dalrymple-White	Coalition Conservative
South Molton	George Lambert	Liberal
South Shields	Havelock Wilson	Coalition Liberal
Southwark Central	James Daniel Gilbert	Coalition Liberal
Southwark North	Edward Strauss	Coalition Liberal
Southwark South East	James Dawes	Coalition Liberal
Sowerby	Robert Hewitt Barker	NADSS
Spelthorne	Philip Pilditch	Coalition Conservative
Spennymoor	Samuel Galbraith	Liberal
Spen Valley	Sir Thomas Whittaker	Coalition Liberal
Stafford	Hon. William Ormsby-Gore	Coalition Conservative
Stalybridge and Hyde	Sir John Wood, Bt	Conservative
Stepney Limehouse	Sir William Pearce	Coalition Liberal
Stepney Mile End	Sir Walter Preston	Coalition Conservative
Stirling and Falkirk Burghs	John Macdonald	Liberal
Stirlingshire East and Clackmannan	Ralph Glyn	Coalition Conservative
Stirlingshire West	Harry Hope	Coalition Conservative
Stockport 	George Wardle	Coalition Labour
Stockport 	Spencer Leigh Hughes	Coalition Liberal
Stockton on Tees	Bertrand Watson	Coalition Liberal
Stoke Newington	George Jones	Coalition Conservative
Stoke-on-Trent	John Ward	Coalition Liberal
Stone	Sir Smith Child, Bt	Coalition Conservative
Stourbridge	John William Wilson	Liberal
Streatham	William Lane-Mitchell	Coalition Conservative
Stretford	Thomas Robinson	Coalition Liberal
Stroud	Sir Ashton Lister	Coalition Liberal
Sudbury	Stephen Howard	Liberal
Sunderland 	Sir Hamar Greenwood, Bt	Coalition Liberal
Sunderland 	Ralph Hudson	Conservative
Surrey East	Sir Stuart Coats, Bt	Coalition Conservative
Swansea East	Jeremiah Williams	Coalition Liberal
Swansea West	Sir Alfred Mond, Bt	Coalition Liberal
Swindon	Sir Frederick William Young	Coalition Conservative
Tamworth	Henry Wilson-Fox	Coalition Conservative
Taunton	Dennis Boles	Coalition Conservative
Tavistock	Charles Williams	Coalition Conservative
Thirsk and Malton	Edmund Turton	Coalition Conservative
Thornbury	Athelstan Rendall	Coalition Liberal
Tipperary East	Pierce McCan	Sinn Féin
Tipperary Mid	Séamus Burke	Sinn Féin
Tipperary North	Joseph MacDonagh	Sinn Féin
Tipperary South	P. J. Moloney	Sinn Féin
Tiverton	Charles Carew	Coalition Conservative
Tonbridge	Herbert Spender-Clay	Coalition Conservative
Torquay	Charles Burn	Coalition Conservative
Totnes	Francis Mildmay	Coalition Conservative
Tottenham North	William Prescott	Coalition Conservative
Tottenham South	Patrick Malone	Conservative
Twickenham	William Joynson-Hicks	Coalition Conservative
Tynemouth	Charles Percy	Coalition Conservative
Tyrone North-East	Thomas Harbison	Irish Nationalist
Tyrone North-West	Arthur Griffith	Sinn Féin
Tyrone South	William Coote	Irish Unionist
University of Wales	Herbert Lewis	Coalition Liberal
Uxbridge	Hon. Sidney Peel	Coalition Conservative
Wakefield	Sir Edward Brotherton, Bt	Coalition Conservative
Wallasey	Bouverie McDonald	Coalition Conservative
Wallsend	Matthew Simm	Coalition NDP
Walsall	Sir Richard Cooper, Bt	National Party
Walthamstow East	Sir Stanley Johnson	Coalition Conservative
Walthamstow West	Charles Jesson	Coalition NDP
Wandsworth Central	Sir John Norton-Griffiths	Conservative
Wansbeck	Robert Mason	Coalition Liberal
Warrington	Harold Smith	Coalition Conservative
Warwick and Leamington	Ernest Pollock	Coalition Conservative
County Waterford	Cathal Brugha	Sinn Féin
Waterford City	William Redmond	Irish Nationalist
Waterloo	Albert Buckley	Coalition Conservative
Watford	Dennis Herbert	Coalition Conservative
Wednesbury	Alfred Short	Labour
Wellingborough	Walter Smith	Labour
Wells	Harry Greer	Coalition Conservative
Wentworth	George Harry Hirst	Labour
West Bromwich	Frederick Roberts	Labour
Westbury	George Palmer	Coalition Conservative
Western Isles	Donald Murray	Liberal
West Ham Plaistow	Will Thorne	Labour
West Ham Silvertown	Jack Jones	National Socialist Party
West Ham Stratford	Leonard Lyle	Coalition Conservative
West Ham Upton	Sir Ernest Wild	Coalition Conservative
Westhoughton	William Wilson	Labour
Westmeath	Laurence Ginnell	Sinn Féin
Westminster Abbey	William Burdett-Coutts	Coalition Conservative
Westminster St George's	Walter Long	Coalition Conservative
Westmorland	John Weston	Coalition Conservative
Weston-super-Mare	Sir Gilbert Wills, Bt	Coalition Conservative
Wexford North	Roger Sweetman	Sinn Féin
Wexford South	James Ryan	Sinn Féin
Whitechapel and St George's	James Kiley	Liberal
Whitehaven	James Augustus Grant	Coalition Conservative
Wicklow East	Seán Etchingham	Sinn Féin
Wicklow West	Robert Barton	Sinn Féin
Widnes	William Walker	Coalition Conservative
Wigan	John Parkinson	Labour
Willesden East	Harry Mallaby-Deeley	Coalition Conservative
Willesden West	Charles Pinkham	Coalition Conservative
Wimbledon	Joseph Hood	Coalition Conservative
Winchester	George Hennessy	Coalition Conservative
Windsor	Ernest Gardner	Coalition Conservative
Wirral	Gershom Stewart	Coalition Conservative
Wolverhampton Bilston	T. E. Hickman	Coalition Conservative
Wolverhampton East	George Thorne	Liberal
Wolverhampton West	Alfred Bird	Coalition Conservative
Woodbridge	Robert Francis Peel	Coalition Conservative
Wood Green	Godfrey Locker-Lampson	Coalition Conservative
Woolwich East	Will Crooks	Labour
Woolwich West	Sir Kingsley Wood	Coalition Conservative
Worcester	Sir Edward Goulding	Coalition Conservative
Workington	Thomas Cape	Labour
The Wrekin	Sir Charles Henry, Bt	Coalition Liberal
Wrexham	Sir Robert Thomas, Bt	Coalition Liberal
Wycombe	William Baring du Pré	Coalition Conservative
Yeovil	Hon. Aubrey Herbert	Coalition Conservative
York	Sir John Butcher	Coalition Conservative
